111111111111
1PMMCMM00001
10C000E00001
10MCM0M00001
10000C000001
111111111111
