111111111111
1P00C0000001
10C000E00001
100C00M00001
10000C000001
111111111111
