11111111111111111
1P0M00CM000M0C001
1000CM00CM0000ME1
11111111111111111