11111111111111
1P0C0C0C0C0C01
1M00C0C0C0C0E1
11111111111111
