111111111
100M00001
100100C01
1P0000CE1
111111111