111111111111111111111111111
1000000000000P0000000000001
1000E0000000000000000000001
111111111111111111111111111