111111111
1000P0001
10E0C0001
11111111