11111111
1C0000C1
11111111
1PE00C01
11111111