1111111111111111111
100000C000000000001
100C0000000C0000001

1111111110111111111
1000000000000000001
10E0000000100000P01
1111111111111111111