111111111111111
1C00P00000001E1
100000000000001
111111111111111