111111111111111111111111111
1000000000000000C0000000001
1000000000C00000C0000000001
111111111111111111111111111