111111111111111111111111111
10000C000000000000000000001
10C000000000000C00000000001
111111111111111111111111111