111111111111111111111
10EP00100000000011111
100000111111111100011
100010000000000001C11
111111111111111111111