11111111111
10EP000C001
10000000001
11111111111