11111111111111111111
10000000000000000C01
10000000000000000001
1111100000P000011111
10000000000000000001
1000E000000000000001
11111111111111111111