1111111111111111111111111111111111
1000C0000000000000011000000000C001
1000000000011111011111110000000001
1111111111110000P00001111111111111
1000000000000000000000000000000001
1000E0000000000C0000000000000C0001
1111111111111111111111111111111111