11111111111111111
1C0000000000000E1
100000C0000000001
10000000000000001
10000000P00000001
10000000000000C01
10000000C00000001
11111111111111111